What is your full name?

I beg your pardon?

What is your full name?

I beg your pardon?

What is your full name?

>Richard Brum
Well hi there, Richard!

The Basement
An Interactive Fiction by Richard Brum
Release 1 / Serial number 171213 / Inform 7 build 6M62 (I6/v6.33 lib 6/12N) SD

You keel over and die. Great job.

* * *

What is your full name?

>Rich Brum
Well hi there, Rich!

The Basement
An Interactive Fiction by Richard Brum
Release 1 / Serial number 171213 / Inform 7 build 6M62 (I6/v6.33 lib 6/12N) SD
You're a kid playing in the basement. You don't remember how you got here. But, here you are.

>health
That's not a verb I recognise.

* * *

>hi
That's not a verb I recognise.

* * *

>where am i
That's not a verb I recognise.

* * *

>help
That's not a verb I recognise.

>?
That's not a verb I recognise.

>eat
(yourself)

* * *

>look at inventory
You can't see any such thing.

* * *

What is your full name?

>Rich Brum Blah Foo Bar Bar
Who are you, a member of the British royal family? No one has that many names. Try again.

What is your full name?

* * *

What is your full name?

>Rich Brum Foo Bar Baz Bart
Who are you, a member of the British royal family? No one has that many names. Try again.

What is your full name?

>Rich Brum
Well hi there, Rich!

The Basement
An Interactive Fiction by Richard Brum
Release 1 / Serial number 171213 / Inform 7 build 6M62 (I6/v6.33 lib 6/12N) SD
You're a kid playing in the basement. You don't remember how you got here. But, here you are.

* * *

What is your full name?

>look
One End of the Basement
You're at one end of the basement. This is where the TV and couches are.

>look at tv
You can't see any such thing.

>take tv
You can't see any such thing.

>help
That's not a verb I recognise.

>eat self
You're plainly inedible.

>look me
As good-looking as ever.

>bite me
That's not a verb I recognise.

>eat me
You're plainly inedible.

>drink me
There's nothing suitable to drink here.

>derp me
That's not a verb I recognise.

>exit
But you aren't in anything at the moment.

>quit
Are you sure you want to quit?

* * *

What is your full name?

>look tv
You can't see any such thing.